1 1 1 1 1 1 1 1 1 1 1 1
1 0 1 0 0 0 0 0 4 4 4 1
0 0 0 0 0 0 0 0 0 0 0 1
0 0 0 3 1 4 4 5 0 0 0 1
0 0 1 2 0 0 0 2 0 0 0 1
1 1 0 0 1 0 0 2 0 0 0 1
0 1 0 0 0 0 0 2 0 1 0 1
0 0 0 0 0 0 0 2 1 0 0 1
0 0 0 0 0 0 0 2 1 0 0 1
1 1 1 1 1 1 1 1 1 1 1 1
endSeg
endSegments