1 1 1 1 1 1 1 1 1 1 1 1
0 0 4 0 1 4 0 0 1 0 0 4
1 1 0 0 0 0 0 0 0 0 0 0
1 0 0 5 1 1 1 4 4 0 0 0
0 0 0 2 0 0 0 0 0 0 0 0
0 0 0 2 0 0 0 0 0 0 1 1
0 0 0 2 0 0 0 2 0 0 0 0
0 1 0 4 4 4 4 5 0 0 0 0
1 0 0 0 0 0 0 2 0 0 0 0
0 0 0 0 0 0 0 2 0 0 0 0
endSeg
endSegments