1 1 1 1 1 1 1 1 1 1 1 1
1 0 0 0 0 0 0 0 0 0 0 1
1 0 0 3 4 4 4 4 0 2 0 1
1 0 0 2 0 0 0 0 0 2 0 1
1 0 0 2 0 0 0 0 0 2 0 1
1 0 0 2 0 0 0 0 0 2 0 1
1 1 1 0 0 0 0 1 0 2 0 1
1 0 1 0 0 0 1 0 0 2 0 1
1 0 0 0 0 0 3 0 0 2 0 1
1 0 0 1 1 1 2 4 4 5 0 1
endSeg
1 1 1 1 1 1 1 1 1 1 1 1
1 0 4 0 0 0 4 0 0 4 0 1
1 0 4 0 0 0 4 0 0 4 0 1
1 0 4 0 0 0 4 0 0 4 0 1
1 0 4 0 0 0 4 0 0 4 0 1
1 0 4 4 4 4 4 0 0 4 0 1
1 1 4 0 0 0 4 0 0 4 0 1
1 0 4 0 0 0 4 0 0 4 0 1
1 0 4 0 0 0 4 0 0 4 0 1
1 0 3 0 0 0 3 0 0 3 0 1
endSeg
endSegments