StartMap
1 1 1 1 1 1 1 1 1 1 1 1 1 1 1 1
1 0 0 0 0 0 0 0 0 0 0 0 0 0 0 1
1 0 0 6 0 0 0 6 0 0 0 0 0 0 0 1
1 4 4 5 5 5 1 1 1 1 1 1 1 1 0 1
1 4 4 4 4 4 4 0 0 0 0 0 0 0 0 1
1 0 0 1 0 1 1 0 1 1 1 1 1 3 0 1
1 0 0 0 0 0 0 0 1 2 2 2 2 2 0 1
1 0 0 0 0 0 0 0 0 0 0 0 0 0 0 1
1 0 0 4 4 4 4 4 4 0 0 0 0 0 0 1
1 1 0 0 0 0 0 0 0 5 5 5 5 5 5 1
1 1 1 0 0 1 0 0 0 2 0 0 3 0 0 1
1 0 0 0 1 0 0 0 0 2 0 0 3 0 0 1
1 0 0 0 0 1 1 0 0 2 0 0 2 0 0 1
1 1 1 1 1 1 1 1 1 1 1 1 1 1 1 1
EndMap
StartDoors
Door: 3 2 maps/map2.txt 1 5
Door: 7 2 maps/map2.txt 3 6
EndDoors
StartObjects
EndObjects
StartMovingBlocks
EndMovingBlocks
StartFallingBlocks
EndFallingBlocks